#Mewni
2 7 8199 6524 4506 8324 986 2597 3617
2 3 2814 212 8296
#Earth
1 9 5163 4624 5054 5627 7120 8315 8285 2992 8228 
1 7 8315 8332 7237 8247 6647 8439 5054 
1 6 5163 1502 3636 6873 5741 5827 
1 10 5827 8785 8812 5765 4462 6005 3195 6964 8934 3953 
1 4 8228 8143 8167 8103 

